1111111111111
1001C000000C1
1000011111J01
1P0011E000001
1111111111111
