1111111111111
10010 00000C1
1000011111001
1P0011E00000
1111111111111
