11111
10C01
10E01
1P001
11111
